Check
	ogoneks
	dotaccents
	caron
	Saltillos
contours + components
compatibility

Starting greek:
	-extrapolate fake thin from Alegreya Serif

Ending
	-Custom parameters for SC exporting
	-new arrows ss0X combs
	-check if some latin glyphs have been re-interpolated
	-Q.corta



Generate
Ve-cy=ve-cy
Ge-cy=ge-cy
De-cy=de-cy
Zhe-cy=zhe-cy
Ze-cy=ze-cy
Ii-cy=ii-cy
Iishort-cy=iishort-cy
Ka-cy=ka-cy
El-cy=el-cy
Em-cy=em-cy
En-cy=en-cy
Pe-cy=pe-cy
Te-cy=te-cy
Che-cy=che-cy
Tse-cy=tse-cy
Sha-cy=sha-cy
Shcha-cy=shcha-cy
Softsign-cy=softsign-cy
Hardsign-cy=hardsign-cy
Yeru-cy=yeru-cy
Ereversed-cy=ereversed-cy
Iu-cy=iu-cy
Ia-cy=ia-cy